Ala	M_ala__L_c	A
Arg	M_arg__L_c	R
Asn	M_asn__L_c	N
Asp	M_asp__L_c	D
Cys	M_cys__L_c	C
Gln	M_gln__L_c	Q
Glu	M_glu__L_c	E
Gly	M_gly_c	G
His	M_his__L_c	H
Ile	M_ile__L_c	I
Leu	M_leu__L_c	L
Lys	M_lys__L_c	K
Met	M_met__L_c	M
Phe	M_phe__L_c	F
Pro	M_pro__L_c	P
Ser	M_ser__L_c	S
Thr	M_thr__L_c	T
Trp	M_trp__L_c	W
Tyr	M_tyr__L_c	Y
Val	M_val__L_c	V